#############
#B#     #   #
# #  ##   # #
# #  ## ### #
#       #   #
######### # #
#         # #
#A###########